"Address A","Address B","Packets","Bytes","Packets A → B","Bytes A → B","Packets B → A","Bytes B → A","Rel Start","Duration","Bits/s A → B","Bits/s B → A"
"192.168.119.140","198.143.164.252",124,49581,62,6363,62,43218,0,68.699060847,740.9708280200298,5032.732554670698
"142.250.179.174","192.168.119.140",1272,659381,690,571297,582,88084,0.004269178,265.282396451,17228.34255549327,2656.3089350339123
"142.251.36.13","192.168.119.140",98,26530,43,19285,55,7245,0.323301696,128.10855410300002,1204.2911660368752,452.42880466358105
"172.217.168.228","192.168.119.140",217,61543,104,48871,113,12672,0.781380948,261.187982084,1496.8835735874777,388.1342441222917
"172.217.168.234","192.168.119.140",53,12195,24,8458,29,3737,1.173816575,67.390839687,1004.0533745278841,443.6211232691774
"192.168.119.140","216.58.208.106",48,15039,28,2952,20,12087,2.973964224,235.85631405499998,100.12875887856417,409.9784243107064
"142.250.179.195","192.168.119.140",48,14350,20,11404,28,2946,3.0693471900000002,236.526408141,385.7159152631027,99.64215068091026
"192.0.76.3","192.168.119.140",40,9310,18,7025,22,2285,3.8764840080000003,60.444572695,929.7774389701143,302.4258289034464
"142.251.39.106","192.168.119.140",177,72563,91,61215,86,11348,9.598882572,245.230481002,1996.9785077247639,370.19867852096087
"2.16.233.180","192.168.119.140",461,289370,224,216690,237,72680,11.472184545,106.531088605,16272.432983648661,5457.93728022329
"151.101.1.16","192.168.119.140",21,6952,10,5815,11,1137,11.639667668,41.797005651,1112.9983900865157,217.62324497478392
"35.170.227.48","192.168.119.140",217,70594,86,18079,131,52515,15.999574107,53.027066209,2727.5127654611297,7922.746439415411
"54.239.29.0","192.168.119.140",209,116804,94,27859,115,88945,16.000855689,112.28899508899998,1984.807147159454,6336.863193370101
"34.205.208.16","192.168.119.140",42,15318,18,12800,24,2518,16.480526472,2.0395384519999986,50207.437814955236,9876.744407660726
"52.45.187.81","192.168.119.140",21,7659,9,6400,12,1259,16.504129055,2.1416751960000013,23906.519576650113,4702.86064796914
"52.46.154.73","192.168.119.140",25,8760,11,6503,14,2257,16.62668964,21.18960289,2455.166350689454,852.1160162242192
"52.46.130.91","192.168.119.140",32,13211,15,9920,17,3291,16.627985283,37.588172743,2111.302417986762,700.4330904833098
"13.227.211.79","192.168.119.140",32,9143,15,7075,17,2068,18.404471475,50.274336798,1125.8229069717265,329.07445535230113
"13.227.211.135","192.168.119.140",32,9143,15,7074,17,2069,18.406087332,50.345120702,1124.0811266493167,328.77068858318296
"192.168.119.140","212.82.100.182",28,6888,16,2162,12,4726,21.493992863,47.199356967,366.4456702681926,801.0278620201101
"52.202.100.92","192.168.119.140",24,8453,10,6422,14,2031,21.495983934,42.672621779,1203.9569601810379,380.75935629518654
"34.98.64.218","192.168.119.140",34,7961,15,5634,19,2327,21.497473122,47.175225326,955.416740217649,394.61390743458804
"104.244.42.67","192.168.119.140",28,6566,13,4500,15,2066,21.499072624,47.458178807,758.562610385927,348.2645229016278
"18.198.126.47","192.168.119.140",24,6228,9,4376,15,1852,21.505348132,47.156424382000004,742.3802898288201,314.18836763322093
"18.211.109.126","192.168.119.140",32,9196,14,6903,18,2293,21.506995343,47.249970114999996,1168.7626439888174,388.2330497850729
"13.227.209.198","192.168.119.140",36,10473,17,8241,19,2232,23.715156323,45.242581625,1457.2112738051562,394.67243819113077
"87.248.116.12","192.168.119.140",70,19195,30,14042,40,5153,26.51177397,42.445754599999994,2646.5779925137676,971.2160942475035
"52.46.149.61","192.168.119.140",26,7611,13,6431,13,1180,27.640473794000002,79.991965028,643.1645976191658,118.01185277415887
"52.214.104.133","192.168.119.140",22,8428,9,6013,13,2415,28.674875577999998,23.495897452,2047.3361402037156,822.2712088129009
"34.246.136.210","192.168.119.140",39,18977,18,14816,21,4161,29.327325654,8.433671189000002,14054.140521223488,3947.035550000738
"172.64.147.134","192.168.119.140",298,202694,167,181766,131,20928,37.618931113,31.334231094000003,46407.01077482134,5343.166056883361
"13.227.219.95","192.168.119.140",86,51594,47,47751,39,3843,38.097718742,30.859610398,12378.898990401958,996.2536663130558
"52.222.137.171","192.168.119.140",28,8143,13,6608,15,1535,38.100319977,11.409751741000001,4633.229644255763,1076.2723220236978
"13.227.219.115","192.168.119.140",36,10557,17,8159,19,2398,41.002500439,27.675800639000002,2358.4502884451495,693.1687451515465
"192.168.119.140","199.232.150.208",145,113288,57,5117,88,108171,49.540512149,19.40051718,2110.046841545077,44605.40881312732
"142.250.179.142","192.168.119.140",54,13810,26,10244,28,3566,51.1368546,17.819990888,4598.880017115304,1600.8986861609892
"104.17.208.240","192.168.119.140",83,29159,38,24437,45,4722,53.484672538,208.48390074500003,937.703099862441,181.19384693499393
"192.168.119.140","216.58.214.22",85,33242,48,5463,37,27779,54.187017041,14.769155989000005,2959.139982850105,15047.034520152492
"104.17.209.240","192.168.119.140",36,9550,15,7188,21,2362,54.600581733,14.352666776999996,4006.502825812802,1316.54975995685
"52.222.139.29","192.168.119.140",58,19045,27,14435,31,4610,54.703214588,133.74353135299998,863.4436285012126,275.7516541316654
"142.251.39.99","192.168.119.140",67,21665,32,10535,35,11130,59.59202679,177.948593077,473.61992889447157,500.36922720412616
"34.104.35.123","192.168.119.140",41,28419,21,26710,20,1709,60.352103517,0.08203016199999524,2604895.501730356,166670.4010654129
"192.168.119.140","199.232.194.133",317,199582,125,12401,192,187181,63.863260652,53.997030677999994,1837.2862128587435,27732.04343271611
"142.251.36.14","192.168.119.140",24,7484,10,6004,14,1480,64.237432719,3.0682628309999984,15654.460730909928,3858.861072909176
"192.168.119.140","199.232.194.217",33,8246,17,2116,16,6130,67.354788059,1.5981178950000015,10592.460076294925,30686.096534824144
"18.195.174.222","192.168.119.140",72,20542,32,15185,40,5357,69.028423987,192.933200252,629.6479809660997,222.12869503031914
"192.168.119.140","209.54.183.244",34,13868,18,6074,16,7794,69.887602694,47.498305063000004,1023.025978201735,1312.7205258650515
"192.168.119.140","216.239.32.36",77,20385,43,6460,34,13925,74.443031703,114.731719819,450.4421277875902,970.9607785514232
"104.16.66.85","192.168.119.140",233,122509,125,86150,108,36359,77.255581488,40.71347260799999,16928.057369013906,7144.367241787308
"104.18.170.12","192.168.119.140",42,9871,18,7459,24,2412,79.641332363,30.246482696,1972.8574922164894,637.9584758313678
"13.227.219.26","192.168.119.140",93,71052,58,67665,35,3387,79.71767217,38.488741579000006,14064.372535769051,703.9980754991469
"156.146.33.8","192.168.119.140",32,7018,16,5412,16,1606,79.722619738,15.14574533199999,2858.6245873634257,848.2910360875206
"172.64.146.158","192.168.119.140",56,12117,25,8459,31,3658,80.034055664,69.925639977,967.7709066696955,418.50171138405796
"13.227.219.62","192.168.119.140",38,12206,18,7258,20,4948,85.063187855,33.14723683400001,1751.699554650124,1194.1870207231761
"192.168.119.140","216.239.32.21",163,108997,77,6587,86,102410,87.568160594,30.410098312999992,1732.8454336983523,26941.050685448346
"35.190.10.96","192.168.119.140",68,21516,33,11635,35,9881,87.966787851,29.88675922099999,3114.4226549192776,2644.9170823598956
"34.102.232.42","192.168.119.140",34,8361,15,5534,19,2827,88.708648472,29.49749813800001,1500.8730500762981,766.7090915369886
"91.198.174.194","192.168.119.140",28,7731,12,6126,16,1605,90.433723327,27.413604495,1787.7255071998513,468.38058097547525
"91.198.174.192","192.168.119.140",48,14346,19,10768,29,3578,90.764558182,27.430507809999995,3140.4449599214336,1043.509664431546
"142.251.39.110","192.168.119.140",260,115803,130,100328,130,15475,91.54155515,170.425504104,4709.529857163919,726.417097316917
"91.198.174.208","192.168.119.140",20,5852,8,4660,12,1192,91.787989469,20.475593145000005,1820.704276354676,465.7252140375051
"52.20.124.79","192.168.119.140",50,15471,19,7888,31,7583,94.86319552,23.200594799,2719.930266732641,2614.7605492689677
"104.108.166.27","192.168.119.140",83,47360,46,43061,37,4299,103.425106783,14.554017760999997,23669.61519884324,2363.05881748745
"13.36.218.177","192.168.119.140",54,17473,25,13073,29,4400,103.64054388,135.204208329,773.5262185442473,260.3469258467596
"80.67.93.35","192.168.119.140",67,17493,31,13357,36,4136,103.641385089,134.753911019,792.9714187288675,245.54389367841554
"52.222.139.127","192.168.119.140",10,1020,4,286,6,734,104.233639185,0.18347978599999237,12470.038525116304,32003.52544557821
"13.227.216.166","192.168.119.140",26,5788,12,4328,14,1460,104.235092954,5.668107053,6108.5649364498695,2060.652681889281
"34.252.39.216","192.168.119.140",26,9367,11,6767,15,2600,104.588536352,1.4941509209999992,36231.949021433575,13920.949823515191
"23.76.204.146","192.168.119.140",116,78377,61,73130,55,5247,105.556276323,12.412504227999989,47133.11586877637,3381.7511139541857
"52.222.139.54","192.168.119.140",56,19445,26,15413,30,4032,105.621123662,12.584922425999991,9797.756062862845,2563.067050247388
"13.227.219.8","192.168.119.140",38,11131,18,8418,20,2713,106.559357962,11.312128726999987,5953.2561576374355,1918.6486048551155
"52.31.4.32","192.168.119.140",28,11358,12,8861,16,2497,106.720093321,3.944367771000003,17971.954978738708,5064.436472397083
"157.240.247.35","192.168.119.140",155,37649,64,22759,91,14890,107.973055628,71.077144995,2561.611049695483,1675.9255033158638
"15.188.95.229","192.168.119.140",38,9452,18,5718,20,3734,107.974769558,10.243487475999999,4465.666610827221,2916.194320536699
"52.222.139.53","192.168.119.140",41,12377,19,9584,22,2793,110.366020283,7.839271264000004,9780.500944277563,2850.2649350341435
"13.227.219.60","192.168.119.140",84,30610,40,25532,44,5078,110.367809005,102.16664603000001,1999.2434707117886,397.62487640116177
"52.222.139.45","192.168.119.140",34,9495,16,7245,18,2250,110.7218539,7.4839514039999955,7744.57193415523,2405.1465634022456
"2.16.233.161","192.168.119.140",116,70065,62,64961,54,5104,112.436917821,5.560893485000008,93454.04680053843,7342.704928648699
"2.21.19.236","192.168.119.140",208,134041,113,117868,95,16173,116.608396607,33.202131914000006,28400.104018694004,3896.858199802645
"104.68.84.169","192.168.119.140",54,14763,25,9305,29,5458,118.3657748,31.45153552900001,2366.8160790229877,1388.2946974000502
"2.16.232.28","192.168.119.140",155,103354,81,95719,74,7635,118.373319433,22.596082174999992,33888.70663814535,2703.123467464555
"104.68.70.99","192.168.119.140",23,5256,11,4024,12,1232,118.374290748,9.248188922999987,3480.8977485245136,1065.722173504523
"172.217.168.227","192.168.119.140",111,29596,50,21574,61,8022,118.521551219,149.01540625500002,1158.2158136364435,430.6668794378209
"142.250.179.130","192.168.119.140",329,203746,161,189645,168,14101,118.523294107,31.437468943,48259.61029976039,3588.3295886362475
"34.96.102.137","192.168.119.140",185,77106,92,67664,93,9442,119.532171842,69.44476511300002,7794.856806257189,1087.7133773451228
"52.222.139.108","192.168.119.140",32,9167,15,7085,17,2082,119.864649488,8.573433061000003,6611.120609063093,1942.7456750980043
"108.156.60.88","192.168.119.140",32,9218,15,7152,17,2066,119.932523734,8.512866465000002,6721.12034591864,1941.5316882924928
"13.227.219.86","192.168.119.140",34,9481,16,7282,18,2199,119.938333499,8.50687284300001,6848.1098842257525,2067.97495679929
"2.21.16.105","192.168.119.140",32,7427,15,5394,17,2033,120.088175774,8.367531907,5157.076241788868,1943.7033740372208
"192.168.119.140","199.232.148.157",31,7083,16,2055,15,5028,120.114544514,8.330386563999994,1973.4978531543704,4828.587448009817
"142.250.179.166","192.168.119.140",36,9509,16,6927,20,2582,120.116305579,8.328812741000007,6653.529347250809,2480.0653637363343
"95.101.239.65","192.168.119.140",80,51402,46,48165,34,3237,120.117968779,8.420133804000017,45761.74309925482,3075.4855686138867
"52.223.40.198","192.168.119.140",60,14126,26,9747,34,4379,120.148156789,47.401816049999994,1645.0002657651344,739.0434147722913
"157.240.201.35","192.168.119.140",73,17717,30,9665,43,8052,120.426175577,92.09872616,839.533870052389,699.4233545433871
"34.242.116.160","192.168.119.140",26,9295,11,6649,15,2646,121.595720867,5.956473177000007,8930.116600775207,3553.78079796228
"104.18.41.98","192.168.119.140",26,5851,11,4073,15,1778,123.987720242,4.457573654000015,7309.80630477315,3190.9736336574174
"3.94.178.28","192.168.119.140",30,8832,13,6621,17,2211,124.398511007,6.034467183000004,8777.576941543202,2931.1618513445133
"52.222.139.77","192.168.119.140",67,19185,31,14388,36,4797,124.40052093,137.57660844699998,836.6538563446464,278.94276820164504
"52.222.139.24","192.168.119.140",28,8180,13,6648,15,1532,124.49335259,3.540471953000008,15021.726116184793,3461.685380564847
"35.201.67.47","192.168.119.140",101,26649,45,19047,56,7602,124.516786029,25.282921568999996,6026.835133912368,2405.418212211993
"35.190.91.160","192.168.119.140",50,10045,22,7087,28,2958,124.52038165,5.832163852999983,9721.263227341662,4057.4991712257142
"34.199.154.34","192.168.119.140",30,7146,13,4660,17,2486,125.202961105,6.624772243999999,5627.363270301736,3002.065469950668
"44.196.120.159","192.168.119.140",30,8693,13,6592,17,2101,125.691343423,7.041505890999986,7489.307090888594,2386.989411097836
"52.222.139.15","192.168.119.140",64,18837,30,14498,34,4339,126.005680651,41.513149803999994,2793.909894758802,836.1687842018514
"99.83.154.140","192.168.119.140",37,10504,16,7813,21,2691,127.07934017,22.943123380000003,2724.3021346642818,938.3203691772152
"142.251.36.6","192.168.119.140",108,30053,48,22116,60,7937,127.489189556,61.691680481999995,2867.9393820634036,1029.2473718320327
"52.18.158.197","192.168.119.140",28,11300,12,8803,16,2497,127.993810832,12.299232027000002,5725.885961448736,1624.1664484536516
"54.88.95.78","192.168.119.140",29,11243,12,7139,17,4104,128.38316718,11.968842815000016,4771.722787471491,2743.122330828267
"151.101.2.202","192.168.119.140",23,5509,11,4307,12,1202,128.384771369,11.377364247000003,3028.46944617119,845.1869687248133
"35.190.59.101","192.168.119.140",40,10052,18,6977,22,3075,128.391633491,21.40661856700001,2607.41787990957,1149.1772940693604
"15.236.176.210","192.168.119.140",33,10729,15,5642,18,5087,128.573055758,21.238004176999993,2125.246780433384,1916.1875881007843
"13.227.219.89","192.168.119.140",28,8118,13,6597,15,1521,128.931631537,7.035380905000011,7501.512812546134,1729.5438817466531
"151.101.1.44","192.168.119.140",90,37463,44,31555,46,5908,129.253518961,20.53919547199999,12290.646941071194,2301.1612146363054
"95.101.238.27","192.168.119.140",101,66269,61,61608,40,4661,129.254825332,20.549965406000013,23983.690009331964,1814.5042710929797
"104.244.42.131","192.168.119.140",28,7009,13,4828,15,2181,129.581627663,20.379017208999983,1895.282760885176,856.1747517586099
"54.155.18.159","192.168.119.140",62,16994,28,11722,34,5272,129.583187475,14.923494454000007,6283.782949700821,2826.147731685952
"54.157.4.134","192.168.119.140",33,11972,13,6897,20,5075,129.584736767,20.283601629999993,2720.226960008582,2001.616909097224
"104.244.42.133","192.168.119.140",28,6693,13,4581,15,2112,129.586363403,20.37506142699999,1798.669423957463,829.2490337040301
"95.101.238.30","192.168.119.140",24,6241,11,4995,13,1246,129.62341421,6.792750710000007,5882.742015126882,1467.4467569265455
"52.222.139.73","192.168.119.140",26,6032,12,4569,14,1463,130.036105916,8.893331004999993,4110.046053548417,1316.0423235590576
"34.110.181.170","192.168.119.140",58,12568,27,8592,31,3976,130.591399626,19.351903924,3551.898576488613,1643.6625628629802
"151.101.194.133","192.168.119.140",42,10847,20,6481,22,4366,131.279268852,18.664218398000003,2777.9357749883525,1871.388303286398
"47.88.251.178","192.168.119.140",30,10155,13,8650,17,1505,132.264364428,9.099926003000007,7604.457440333754,1323.0876818152947
"47.91.64.21","192.168.119.140",188,85474,92,75573,96,9901,133.594909177,33.954518707000005,17805.700773351266,2332.7675672125083
"52.208.25.37","192.168.119.140",30,7741,13,5314,17,2427,134.194845807,15.614520094999989,2722.5940817491405,1243.4580045926166
"13.227.219.82","192.168.119.140",32,9314,15,7132,17,2182,134.292804246,15.507254867,3679.3101351172886,1125.6666734192265
"67.220.240.183","192.168.119.140",29,10147,14,7070,15,3077,136.93959234,9.616437211000004,5881.596141999702,2559.783780612883
"172.217.168.226","192.168.119.140",46,12547,21,9551,25,2996,138.214208581,11.579177162999997,6598.741769333443,2069.9225568969737
"142.250.179.194","192.168.119.140",21,9175,9,7959,12,1216,139.105380088,3.8894909770000083,16370.265511995263,2501.098487572087
"52.222.139.5","192.168.119.140",32,9421,15,7251,17,2170,140.811068574,9.142639332000016,6344.776151998806,1898.7952351175577
"141.226.228.48","192.168.119.140",62,14075,28,10199,34,3876,141.278366533,8.676637744000004,9403.642563782476,3573.7345403687495
"151.101.1.69","192.168.119.140",23,7168,11,5962,12,1206,144.783157716,4.324784265999995,11028.526989188797,2230.862722066704
"142.250.179.164","192.168.119.140",20,6672,9,5552,11,1120,144.962728264,3.0089885440000046,14761.106381932417,2977.7448032716693
"151.101.65.69","192.168.119.140",96,67259,62,63918,34,3341,144.963723173,4.835716036000008,105743.18181490489,5527.206271216202
"80.67.93.247","192.168.119.140",147,94998,74,89184,73,5814,147.003098364,20.532804603999978,34747.90773886823,2265.2531350217514
"104.18.12.76","192.168.119.140",69,47858,40,45306,29,2552,147.072768189,2.415141816000016,150073.1748333894,8453.333822778655
"65.9.78.68","192.168.119.140",85,58233,51,54873,34,3360,148.580342795,18.957092797,23156.71525696546,1417.938936515298
"47.246.48.251","192.168.119.140",176,87625,88,79968,88,7657,149.188731744,90.890165102,7038.649333314092,673.95630683756
"52.54.211.78","192.168.119.140",31,9858,13,7445,18,2413,150.252706163,17.35074487099999,3432.7056528592325,1112.5747132772772
"34.202.126.101","192.168.119.140",31,9160,13,6872,18,2288,150.444084722,17.16542316099998,3202.7174328510614,1066.3296691448236
"34.120.133.55","192.168.119.140",38,10805,17,8388,21,2417,150.475575084,17.04835533299999,3936.0981566420546,1134.185651478761
"47.88.251.189","192.168.119.140",267,91183,116,74423,151,16760,150.558802637,89.68468932399998,6638.63591977313,1495.0154927293668
"47.74.138.66","192.168.119.140",215,80396,97,69970,118,10426,150.872623951,77.89708503699998,7185.891484053892,1070.7460999392008
"47.88.128.4","192.168.119.140",25,9732,11,8521,14,1211,150.966189713,5.0221845689999896,13573.376100268159,1929.0410113161295
"192.168.119.140","216.239.34.36",74,19694,41,5877,33,13817,151.128077363,61.38853229100002,765.8759420591795,1800.596884708471
"35.168.73.109","192.168.119.140",35,7947,15,5050,20,2897,151.967143235,15.642080843000002,2582.7765759233644,1481.6443050396012
"47.246.48.252","192.168.119.140",534,259696,261,234775,273,24921,152.269632158,87.81035938899998,21389.275856161483,2270.4382647701
"54.192.85.4","192.168.119.140",38,12366,18,10097,20,2269,152.422713387,15.115740656000014,5343.833414337982,1200.8673880492108
"178.250.2.130","192.168.119.140",72,49992,40,46976,32,3016,155.939688383,11.597646061999995,32403.816946211628,2080.422171103846
"59.82.33.225","192.168.119.140",36,10553,16,4892,20,5661,156.249539059,11.520941072999989,3396.944724569206,3930.9288809865648
"34.251.158.83","192.168.119.140",31,9849,13,6670,18,3179,156.555925259,10.994314562,4853.417618632622,2313.1955936481418
"104.16.48.182","192.168.119.140",63,15621,28,10594,35,5027,157.84880677,31.140677064999977,2721.5850131677303,1291.4298528595602
"3.220.55.122","192.168.119.140",35,12105,15,7029,20,5076,159.239783038,8.375560024999999,6713.819712610801,4848.392212435969
"2.16.42.31","192.168.119.140",226,82949,106,69866,120,13083,159.242678441,80.84797594699998,6913.320877277201,1294.5778638739534
"47.254.175.252","192.168.119.140",30,9408,13,7343,17,2065,160.192874349,7.3449695820000045,7997.854769060085,2249.158395493542
"178.250.2.146","192.168.119.140",40,14345,17,11533,23,2812,163.1725722,4.366201379000017,21131.41195084571,5152.304726071113
"104.16.49.182","192.168.119.140",65,39058,33,35760,32,3298,164.002787605,3.534299857999997,80943.8959607372,7465.12776505904
"13.227.219.40","192.168.119.140",109,52052,54,46360,55,5692,166.723272348,22.265055950999994,16657.49238700398,2045.1778832361226
"13.227.219.37","192.168.119.140",48,26797,23,24045,25,2752,167.176813404,18.35442387399999,10480.307163031583,1199.4928389545817
"13.227.219.2","192.168.119.140",46,26532,22,23846,24,2686,167.277424712,18.12827736,10523.22822580645,1185.330496289362
"52.222.139.28","192.168.119.140",26,9560,12,7277,14,2283,168.344599521,20.080869637000006,2899.077632212407,909.5223628337125
"172.217.168.194","192.168.119.140",36,11064,16,8394,20,2670,169.749356462,19.425930951999987,3456.8227471788887,1099.5612026408903
"47.246.165.120","192.168.119.140",87,20249,37,13954,50,6295,170.164023407,91.97553275000001,1213.7140896310816,547.5369208992159
"192.168.119.140","207.241.224.2",281,158315,146,14229,135,144086,170.183168031,18.94132857599999,6009.715714674484,60855.71006146516
"142.250.179.132","192.168.119.140",99,33622,47,25563,52,8059,171.174250055,80.190181609,2550.2373968566726,803.9887016886877
"192.168.119.140","207.241.225.102",33,9518,18,2339,15,7179,172.0516007,17.07865572,1095.6365832755366,3362.7939424262836
"104.16.45.182","192.168.119.140",26,5827,12,4483,14,1344,172.175314231,11.977652367000019,2994.2428533666543,897.671736543561
"192.168.119.140","207.241.239.241",74,20888,44,5704,30,15184,173.014773909,16.305856773999977,2798.5036684954302,7449.593215714343
"142.251.36.2","192.168.119.140",38,11666,17,9113,21,2553,173.016282887,16.152581060000017,4513.458234890909,1264.441882330351
"52.46.153.177","192.168.119.140",29,10805,14,7070,15,3735,174.39544142,13.480000581000013,4195.8455164846955,2216.6171151443195
"104.16.47.182","192.168.119.140",36,9175,16,5563,20,3612,176.425248554,12.755724870999984,3488.943235298169,2265.3357839110167
"52.222.139.41","192.168.119.140",28,8112,13,6586,15,1526,176.48539131,7.6732449439999755,6866.456158316555,1590.982705373681
"192.168.119.140","204.79.197.200",113,39678,58,6882,55,32796,178.610327291,33.91965232300001,1623.1298444845202,7734.984943288917
"142.251.39.109","192.168.119.140",36,9668,15,7075,21,2593,181.261333501,7.902063865000002,7162.6857194478,2625.1369710993845
"142.251.39.104","192.168.119.140",155,122323,98,116547,57,5776,183.901061901,28.622158565000007,32575.320896311994,1614.4135284228514
"104.73.152.39","192.168.119.140",40,11696,18,9370,22,2326,184.635670563,3.6482799580000176,20546.66880364438,5100.485767051957
"52.86.105.134","192.168.119.140",59,14047,25,9254,34,4793,185.746010297,76.31712601800001,970.0574938125809,502.42982146571217
"96.17.178.178","192.168.119.140",70,20259,33,15992,37,4267,185.754206861,26.774753521000008,4778.232595107069,1274.9323713933131
"3.215.128.62","192.168.119.140",33,11973,13,6897,20,5076,188.964238095,23.62984743199999,2335.012960146311,1718.504536132039
"13.227.219.93","192.168.119.140",34,10587,16,8349,18,2238,189.009949931,23.524970787,2839.195874237155,761.0636443337828
"192.168.119.140","216.239.34.178",39,9767,23,2888,16,6879,189.460127314,32.39287180299999,713.2433376240594,1698.8922851509367
"52.46.144.253","192.168.119.140",29,10146,14,7070,15,3076,189.671626429,20.853277237999976,2712.283510859065,1180.0543252337318
"142.250.27.155","192.168.119.140",69,12912,32,8444,37,4468,191.580131642,20.944017013000007,3225.360252432487,1706.6449085585446
"142.250.27.157","192.168.119.140",20,6954,8,5735,12,1219,191.793492913,1.158834349000017,39591.508518530565,8415.352900451397
"192.29.153.203","192.168.119.140",27,8898,13,5976,14,2922,192.001247602,18.721888933999992,2553.5884850367856,1248.5919600531272
"192.168.119.140","216.58.214.2",36,10812,20,2692,16,8120,195.916789284,16.607462965999986,1296.7664021946082,3911.4944969614485
"13.227.219.39","192.168.119.140",276,203699,149,194060,127,9639,195.952411509,25.906365232000013,59926.58507270439,2976.5657709770053
"66.254.114.41","192.168.119.140",110,70877,62,64890,48,5987,197.202253176,15.32180990500001,33881.114778130366,3126.0014513278857
"192.168.119.140","205.185.208.142",146,77761,71,6290,75,71471,197.259629689,15.253546744000005,3298.904893695849,37484.265764282354
"95.101.239.55","192.168.119.140",79,44871,48,41143,31,3728,197.404033405,15.12551886,21760.840275729886,1971.7670696818661
"95.101.239.56","192.168.119.140",24,6241,11,4995,13,1246,197.707644669,1.3639998730000116,29296.190411008683,7307.918568992356
"66.254.114.181","192.168.119.140",22,6390,9,5158,13,1232,199.69013257,6.989588330000004,5903.638104534832,1410.0973526147561
"64.210.135.118","192.168.119.140",16,4472,6,3373,10,1099,199.974039777,5.739361325999994,4701.568426744497,1531.8777648954053
"64.210.135.119","192.168.119.140",16,4473,6,3374,10,1099,199.975796466,10.463080333000022,2579.737433045277,840.2879190624658
"192.168.119.140","203.119.169.80",29,12662,16,1335,13,11327,200.080294358,3.445336284000007,3099.84254645837,26301.061066467388
"192.168.119.140","203.119.144.26",54,17268,30,3392,24,13876,200.138829478,12.515032012000006,2168.272520116666,8869.973316373484
"52.222.139.92","192.168.119.140",49,11879,22,8713,27,3166,200.857454399,11.654914783999999,5980.652908392814,2173.1604622944624
"66.254.114.38","192.168.119.140",51,13502,20,9000,31,4502,203.173344243,9.351194313000008,7699.551264794677,3851.4866437895153
"104.18.59.150","192.168.119.140",215,119147,114,108122,101,11025,203.174925669,58.796632337999995,14711.31875423705,1500.0859146655027
"142.250.179.131","192.168.119.140",285,198231,153,186774,132,11457,203.926125361,59.82281329599999,24976.959752909315,1532.1245349410626
"64.210.135.117","192.168.119.140",241,186455,138,178426,103,8029,203.956973304,8.55704121299999,166810.92967408634,7506.332901893442
"192.168.119.140","216.18.168.30",22,6374,13,1226,9,5148,205.291453098,5.038480553999989,1946.618607511256,8173.89281522671
"13.107.42.14","192.168.119.140",95,25951,45,19078,50,6873,206.153771372,15.709189120000019,9715.587407735009,3500.1170066758946
"151.101.2.114","192.168.119.140",430,256181,227,236014,203,20167,210.740310712,52.389120838,36040.1543259049,3079.570670767514
"8.238.16.122","192.168.119.140",3656,3363176,2374,3268111,1282,95065,210.941494608,50.340737356000005,519358.4634072478,15107.446571983024
"172.217.168.195","192.168.119.140",105,27156,50,20094,55,7062,213.026271762,54.999203962999985,2922.805939303119,1027.2148672916605
"104.18.51.106","192.168.119.140",153,83995,80,75660,73,8335,213.027981419,27.05191517899999,22374.755945925415,2464.890177230879
"8.238.17.122","192.168.119.140",52,17308,22,13781,30,3527,215.16168629,47.54975556299999,2318.5818453667835,593.3994752636706
"151.139.128.11","192.168.119.140",38,8485,18,6220,20,2265,215.2297222,6.2235589329999925,7995.425211794979,2911.517380179361
"13.227.219.5","192.168.119.140",32,9651,15,7453,17,2198,215.238002564,6.630205493000005,8992.783114030091,2652.1048282085253
"104.18.41.15","192.168.119.140",26,6233,12,4399,14,1834,215.239661804,6.623207124000004,5313.4379374121445,2215.2410041404573
"52.94.225.56","192.168.119.140",31,10941,15,7153,16,3788,215.538254159,5.787740377000006,9887.105549413269,5235.894844285958
"142.250.27.156","192.168.119.140",67,18487,30,13543,37,4944,216.775289162,45.834438946999995,2363.8120698997113,862.9319112149577
"47.88.198.68","192.168.119.140",75,25118,32,20168,43,4950,218.034145574,22.19327696899998,7269.949373648991,1784.3241471421316
"52.222.139.67","192.168.119.140",32,9018,15,6972,17,2046,218.104625939,21.97578717600001,2538.066079421881,744.8197358716535
"13.227.219.77","192.168.119.140",38,13190,18,10886,20,2304,218.106555391,3.7504985159999933,23220.37980510433,4914.54667196035
"184.72.155.79","192.168.119.140",36,12213,15,7071,21,5142,218.643261149,21.517736611999993,2628.9010326696352,1911.7252312243338
"104.18.63.132","192.168.119.140",20,4838,8,3632,12,1206,218.999679067,3.5820915350000178,8111.462176803323,2693.3985091477994
"104.18.63.124","192.168.119.140",221,178229,135,171417,86,6812,219.001563466,42.96637954900001,31916.48945976683,1268.3405158177525
"52.17.99.225","192.168.119.140",62,16929,28,11780,34,5149,219.805228981,18.701099234999987,5039.275970667297,2202.6512710497377
"108.128.24.220","192.168.119.140",32,9750,14,7554,18,2196,220.429592917,19.661286004999994,3073.6544895706083,893.532599827516
"8.238.16.250","192.168.119.140",19,6077,8,4922,11,1155,220.500713498,3.5609824249999917,11057.622672765674,2594.789554458422
"2.16.232.64","192.168.119.140",56,26790,26,23753,30,3037,222.487278584,17.725319400000018,10720.483829476145,1370.6946234210018
"13.227.219.52","192.168.119.140",224,174233,136,166331,88,7902,222.551258917,39.41494058699996,33759.98999828205,1603.8588174569068
"13.227.219.42","192.168.119.140",24,8278,11,7006,13,1272,222.552753832,3.6425575549999962,15386.990913311749,2793.641513236161
"167.44.7.21","192.168.119.140",59,25465,27,19696,32,5769,225.051209879,14.696525723000008,10721.445528680746,3140.334040158368
"142.250.179.173","192.168.119.140",141,98256,83,93006,58,5250,228.76815027,33.18676315799999,22420.023201950626,1265.5648217345201
"47.241.74.86","192.168.119.140",28,7139,12,4733,16,2406,229.788509158,10.449076948999988,3623.669361878296,1842.0765866636764
"104.18.55.220","192.168.119.140",46,10988,19,7967,27,3021,231.308577762,30.65900785300002,2078.8670104914486,788.2838256175055
"52.210.26.59","192.168.119.140",24,8864,10,6338,14,2526,235.697754823,23.00322509100002,2204.2126614601475,878.4855132294625
"13.227.219.54","192.168.119.140",64,19934,30,16009,34,3925,239.304450519,22.664211410999997,5650.847394489124,1385.444189104242
"13.227.219.110","192.168.119.140",32,10108,15,7908,17,2200,239.305726317,22.66524152599999,2791.234319185522,776.5194110025478
"47.91.64.6","192.168.119.140",64,22305,28,18765,36,3540,239.947566988,22.021470103000013,6816.983575476596,1286.0176849020597
"142.250.179.206","192.168.119.140",38,12100,16,9514,22,2586,240.560153909,21.408005409999987,3555.305529045083,966.3674687944697
"54.239.26.255","192.168.119.140",29,10146,14,7070,15,3076,240.56128163099999,18.455322153999987,3064.6986017386453,1333.3823053674785
"151.101.1.21","192.168.119.140",111,62852,57,55059,54,7793,240.79902687,21.16940958799998,20807.00447355341,2945.004193000267
"3.209.46.33","192.168.119.140",26,7923,11,5753,15,2170,241.089398596,17.71660625199999,2597.788726879023,979.8716386802504
"151.101.2.133","192.168.119.140",3414,3529937,2567,3465627,847,64310,241.090738144,27.818656223000005,996633.9055974032,18494.063691496227
"54.171.150.101","192.168.119.140",28,11298,12,8803,16,2495,245.362265089,13.007115290000002,5414.267378266622,1534.5447130268342
"3.226.203.17","192.168.119.140",35,12105,15,7029,20,5076,249.158978071,12.89455083499999,4360.9118859237915,3149.2372646107788
"104.18.55.36","192.168.119.140",45,9186,20,6559,25,2627,252.141675768,14.478985160000008,3624.0108971836235,1451.4829435739257
"192.168.119.140","192.229.221.25",55,16183,30,5842,25,10341,252.753146576,9.214268828000002,5072.133326301514,8978.249011859629
"142.251.36.3","192.168.119.140",66,30833,30,27023,36,3810,254.202839673,13.980863658999994,15462.850169548321,2180.1228267024053
"151.101.1.35","192.168.119.140",7,478,3,206,4,272,255.601805671,0.25283081500001003,6518.192808103453,8606.545843709413
"13.227.219.102","192.168.119.140",28,8117,13,6597,15,1520,257.506296767,2.9178484889999936,18087.29966581898,4167.454220410012
"13.227.219.83","192.168.119.140",25,7933,12,6536,13,1397,258.650695808,2.763451261,18921.267307272403,4044.2182417777767
"52.222.139.123","192.168.119.140",59,19901,29,16102,30,3799,261.254350008,4.429932142999974,29078.549251268018,6860.601701997714
"52.222.139.27","192.168.119.140",22,7569,10,6373,12,1196,262.861700149,2.471044376000009,20632.571594092577,3872.0470149905414
"13.227.219.59","192.168.119.140",55,18022,26,14814,29,3208,264.331057649,3.0771654430000126,38513.36634160931,8340.143055480132
"13.227.219.23","192.168.119.140",88,39845,43,35066,45,4779,264.332675951,4.536910535000004,61832.38524010254,8426.879856911255
"142.251.39.100","192.168.119.140",33,8915,16,6648,17,2267,264.468661571,3.571346935000008,14891.860401123387,5078.196078421588
"142.251.36.10","192.168.119.140",16,6845,7,5816,9,1029,266.442166145,2.4304161590000035,19144.046515533366,3387.0742545536164

