"Address A","Address B","Packets","Bytes","Packets A → B","Bytes A → B","Packets B → A","Bytes B → A","Rel Start","Duration","Bits/s A → B","Bits/s B → A"
"192.168.119.140","198.143.164.252",106,47666,54,5711,52,41955,0,56.839996488,803.8001904107366,5904.996846205998
"142.250.179.138","192.168.119.140",97,23279,43,16970,54,6309,0.819485301,242.951958181,558.7936027206595,207.7447754604974
"142.250.179.173","192.168.119.140",38,10308,17,7949,21,2359,0.820410951,55.891477788,1137.776321485157,337.654339210402
"142.251.36.36","192.168.119.140",95,27445,45,21879,50,5566,0.886674639,242.955882955,720.427091005733,183.2760724227757
"142.250.179.195","192.168.119.140",37,12737,16,10461,21,2276,2.102392937,265.04056267600004,315.75544194080493,68.69891844539451
"192.168.119.140","216.58.208.106",106,35193,59,12990,47,22203,2.103526561,205.572719468,505.51454623421694,864.044608932896
"172.217.168.232","192.168.119.140",88,66571,52,63182,36,3389,2.202108084,54.513854194,9272.065009405122,497.3414630254496
"192.0.76.3","192.168.119.140",32,8728,14,6707,18,2021,2.831471664,54.033061316,993.0216555046762,299.22420840538996
"142.251.36.46","192.168.119.140",120,65972,65,59915,55,6057,3.36647731,200.720238195,2388.0003546744497,241.4106342028397
"142.250.179.170","192.168.119.140",76,22675,34,16838,42,5837,9.530329214,238.689192379,564.3489705479071,195.63516694905178
"52.222.142.236","192.168.119.140",414,287490,249,220503,165,66987,10.440774857,46.429652696,37993.4782530039,11542.106582377439
"13.227.209.198","192.168.119.140",28,7418,13,5881,15,1537,10.690205002,17.872707335999998,2632.3935772860686,687.9763523701221
"151.101.1.16","192.168.119.140",21,6923,10,5799,11,1124,10.691040962,30.232512784,1534.5069174849439,297.42813851579183
"44.199.153.86","192.168.119.140",211,67366,83,17393,128,49973,13.260946751,43.709023887,3183.4158630429724,9146.48657068053
"54.236.141.118","192.168.119.140",63,22977,27,19200,36,3777,13.955092822,1.7681105430000006,86872.39641667582,17089.42923259295
"52.46.154.73","192.168.119.140",27,8860,13,6611,14,2249,13.956900786,13.040304378,4055.733552448832,1379.722395924584
"52.46.155.104","192.168.119.140",32,13195,15,9920,17,3275,13.95756622,27.067557640999997,2931.92319205746,967.9484328617118
"13.227.211.79","192.168.119.140",64,18273,30,14150,34,4123,15.770452513,41.116887176999995,2753.1267022402885,802.2008051828063
"104.244.42.131","192.168.119.140",28,6567,13,4508,15,2059,17.997527535,39.137938651,921.4588515146171,420.87040267715093
"54.86.212.146","192.168.119.140",24,8445,10,6422,14,2023,17.998800902,35.123241995,1462.7351315494645,460.77751029656906
"18.198.126.47","192.168.119.140",24,6221,9,4376,15,1845,18.000145312,39.135061024,894.5431304816661,377.1554103607573
"192.168.119.140","212.82.100.182",56,14529,32,4373,24,10156,18.089458988,131.228991013,266.5874341481019,619.131484383289
"3.230.192.196","192.168.119.140",32,9189,14,6903,18,2286,18.186347704,39.002556573,1415.907182818613,468.89233955140503
"34.98.64.218","192.168.119.140",34,8033,15,5713,19,2320,18.187768314,38.930711357999996,1173.983171787282,476.7444352435663
"52.46.138.21","192.168.119.140",151,97665,63,17322,88,80343,19.35293931,61.873557366,2239.6643396513127,10388.024018046728
"192.168.119.140","209.54.180.63",38,13312,20,5352,18,7960,23.825856421,17.261183792999997,2480.478773267182,3689.202360838335
"192.168.119.140","209.54.181.12",25,7557,12,1126,13,6431,24.417647726,22.963735538,392.2706732575679,2240.402042379591
"52.94.232.195","192.168.119.140",26,7614,13,6431,13,1183,24.683968917,18.533752686,2775.908412701693,510.6359278846374
"87.248.116.11","192.168.119.140",83,24535,36,19432,47,5103,26.084641909,30.790680661000003,5048.800372799267,1325.8557174966375
"54.170.186.82","192.168.119.140",22,8420,9,6013,13,2407,26.959489872,1.6203756610000006,29686.94306992555,11883.664056096923
"34.255.149.120","192.168.119.140",35,17325,16,14517,19,2808,27.63590423,0.7182786899999982,161686.5453714077,31274.768850514076
"87.248.116.12","192.168.119.140",180,112016,100,104360,80,7656,28.514389791,28.608237795999997,29183.202612945734,2140.921801501653
"54.194.222.229","192.168.119.140",22,7785,9,5255,13,2530,28.633740718,12.178078439000004,3452.104550859839,1662.0027618792376
"104.18.40.122","192.168.119.140",1630,1310317,942,1254544,688,55773,39.533530411,36.10359903,277987.5765754094,12358.43550193561
"172.64.147.134","192.168.119.140",20,4845,8,3634,12,1211,39.69042469,14.510474934999998,2003.5181570712664,667.6556104054221
"13.227.219.15","192.168.119.140",135,74580,71,68366,64,6214,41.101122497,34.331234759000004,15930.915501273128,1448.0108376226665
"52.222.137.187","192.168.119.140",222,160650,123,152433,99,8217,41.102498052,15.784542723999998,77256.84686106464,4164.580574136625
"52.222.137.179","192.168.119.140",22,7588,10,6379,12,1209,41.116672628,2.032028591999996,25113.819855149017,4759.775545520482
"52.222.137.45","192.168.119.140",22,7588,10,6379,12,1209,41.11758536,2.036877464,25054.035356542197,4748.444700746122
"13.227.211.40","192.168.119.140",34,10479,16,8303,18,2176,44.53608261,12.587458124999998,5276.998687135653,1382.963885728915
"52.222.139.7","192.168.119.140",67,40152,36,37026,31,3126,44.538165111,12.585807041000002,23535.08194071795,1987.0001119938506
"13.227.219.103","192.168.119.140",106,85825,67,82128,39,3697,44.547470397,12.586911335000003,52198.98532001535,2349.7424596738842
"192.168.119.140","199.232.150.208",768,605335,325,24579,443,580756,48.040872415,27.591361021999994,7126.578491115944,168387.7789245507
"157.240.247.8","192.168.119.140",639,421325,341,395996,298,25329,53.020448707,214.19066097799998,14790.411428467412,946.0356444803763
"104.81.140.201","192.168.119.140",65,19986,30,16233,35,3753,53.11161993,4.011802103999997,32370.490027541022,7483.918503872448
"142.250.179.142","192.168.119.140",179,81190,86,71252,93,9938,54.182398696999996,21.461073657,26560.460539404412,3704.5676870909033
"192.168.119.140","216.58.214.14",27,9690,16,1567,11,8123,54.400761822,0.5244125839999967,23904.842069922714,123917.6975966702
"142.250.179.174","192.168.119.140",816,520244,419,465423,397,54821,55.117900587,51.74470902699999,71956.80621292444,8475.610516452196
"142.250.179.202","192.168.119.140",318,207271,171,193991,147,13280,57.426987556,204.23840141600002,7598.61019886744,520.1764176738076
"192.168.119.140","216.58.214.22",94,70041,37,4075,57,65966,58.078171655,17.554304027999997,1857.0944167311538,30062.598845174798
"142.251.36.35","192.168.119.140",66,40615,35,37367,31,3248,58.778351535,16.846690999000003,17744.493563617,1542.38004374523
"142.251.39.99","192.168.119.140",38,13913,17,11422,21,2491,58.963229894,85.72980185400002,1065.8603895482647,232.45125462832493
"52.46.145.112","192.168.119.140",65,23060,31,14947,34,8113,60.118363039,38.694200263,3090.282243521142,1677.3573186383237
"142.251.36.3","192.168.119.140",65,23505,28,13420,37,10085,60.378468244,207.34105294499997,517.794225866494,389.1173448482557
"142.251.39.109","192.168.119.140",86,23783,39,17678,47,6105,61.140019267,146.535625343,965.1168421942782,333.2977894329714
"34.96.67.224","192.168.119.140",113,60331,53,54472,60,5859,61.457066853,45.737226758000006,9527.818603994774,1024.8107137759835
"104.17.208.240","192.168.119.140",36,11460,17,9394,19,2066,61.45871731,13.967980330000003,5380.305400243929,1183.2777258786414
"52.222.139.106","192.168.119.140",32,9727,15,7550,17,2177,62.084982849,13.558228822000004,4454.8591702474505,1284.533564719033
"35.168.119.96","192.168.119.140",33,11959,13,6897,20,5062,62.489645337,13.239690390999996,4167.469054828294,3058.681797236599
"142.251.36.33","192.168.119.140",43,16330,19,13563,24,2767,64.194051079,11.456305607999994,9471.1160571896,1932.2110248649724
"104.17.209.240","192.168.119.140",69,31253,34,27993,35,3260,67.32210925,8.338571279999996,26856.399313528455,3127.634114317964
"172.217.168.228","192.168.119.140",39,12655,18,10457,21,2198,67.963764114,147.153124934,568.4962520335246,119.49457415795038
"192.168.119.140","199.232.194.133",1208,1019244,393,34532,815,984712,67.965182742,39.22584225200001,7042.704098620458,200829.23776093908
"13.227.219.121","192.168.119.140",38,13157,18,10904,20,2253,72.903318029,2.7384645969999895,31854.34644492515,6581.790401725639
"13.227.219.68","192.168.119.140",75,60608,51,58047,24,2561,73.863753672,1.7788286610000057,261057.18340457891,11517.691641241177
"91.228.74.159","192.168.119.140",43,17600,20,15119,23,2481,73.869927676,33.33004841099999,3628.9176213762094,595.4986850078957
"13.227.219.25","192.168.119.140",38,12118,18,7259,20,4859,74.867465853,32.237547821999996,1801.3777077786822,1205.7989092294554
"92.123.125.236","192.168.119.140",25,5872,12,4500,13,1372,75.162467509,11.485848507,3134.2917310862977,955.6107233445335
"142.251.39.104","192.168.119.140",1374,1007458,730,958852,644,48606,75.16409359,190.92046439799998,40178.07113651855,2036.7015197982803
"142.250.179.206","192.168.119.140",64,32663,30,29379,34,3284,75.167502735,31.937600161000006,7359.100208380868,822.6040738051933
"192.168.119.140","199.232.194.217",41,15351,21,2321,20,13030,75.169163452,31.936603833999996,581.4018327218732,3263.966342251619
"54.192.85.4","192.168.119.140",28,8129,13,6602,15,1527,75.170825888,18.492786531000007,2856.032535251676,660.5818965963813
"142.251.36.34","192.168.119.140",24,7379,10,5898,14,1481,75.179755947,23.842600292,1978.978778410836,496.9256647722021
"142.251.39.110","192.168.119.140",19,6994,8,5840,11,1154,75.897484315,2.1174582069999985,22064.189907291064,4359.944375516076
"13.227.219.89","192.168.119.140",72,23748,34,19227,38,4521,76.006157196,96.764802503,1589.5862547255367,373.77227116108344
"52.222.139.100","192.168.119.140",36,9518,17,7340,19,2178,79.690589001,27.504861876999996,2134.895287334731,633.4880021546383
"13.227.219.52","192.168.119.140",252,188440,151,179292,101,9148,80.00852012,26.990721518,53141.81760733767,2711.4503015858204
"104.16.65.85","192.168.119.140",46,11067,20,8105,26,2962,80.196701303,26.788093125000003,2420.478370649236,884.5721078177712
"192.168.119.140","216.239.34.36",106,29343,60,8896,46,20447,82.474959282,182.04650163000002,390.93308227721525,898.5396507781273
"104.16.66.85","192.168.119.140",1124,758731,565,697500,559,61231,82.577060059,24.412217909999995,228574.06977816057,20065.69013130688
"18.195.174.222","192.168.119.140",38,10427,17,7689,21,2738,83.206522246,16.548600691999994,3717.0514380552086,1323.616443932262
"104.16.148.64","192.168.119.140",422,289909,233,276851,189,13058,85.16766631,179.60698959399997,12331.413187240398,581.6254714593233
"104.16.149.64","192.168.119.140",209,108183,103,98590,106,9593,85.954412771,74.494468485,10587.631753608854,1030.1972959972586
"104.18.169.12","192.168.119.140",40,9764,16,7352,24,2412,86.457269175,11.34490178,5184.355152698377,1700.8520985185646
"156.146.33.8","192.168.119.140",28,6691,13,5151,15,1540,86.461196195,8.098254378999997,5088.504024627653,1521.3155111486287
"13.227.219.91","192.168.119.140",89,66230,54,62881,35,3349,86.462731076,20.34017059,24731.749312236225,1317.196425735582
"172.64.146.158","192.168.119.140",25,5873,10,4079,15,1794,90.744390656,16.347993455000008,1996.0859471728963,877.9059056700603
"91.198.174.194","192.168.119.140",59,16473,25,12673,34,3800,93.908156415,13.197027889000012,7682.335814756109,2303.5489699418617
"3.231.91.17","192.168.119.140",44,14352,17,7562,27,6790,94.135851054,13.128186415000002,4608.100318477996,4137.662147906055
"23.46.214.47","192.168.119.140",141,90400,72,84864,69,5536,94.86550419,12.244480851000006,55446.368715955265,3616.9765414254375
"91.198.174.192","192.168.119.140",190,120676,95,111955,95,8721,97.257855204,9.937200352000005,90130.01331101666,7020.890948018189
"35.190.10.96","192.168.119.140",68,21934,32,11596,36,10338,98.65166698,8.346857923000002,11114.122326723109,9908.399156059288
"192.168.119.140","216.239.36.21",164,109261,77,6551,87,102710,99.304530924,7.792484075999994,6725.454872780679,105445.19462422584
"91.198.174.208","192.168.119.140",20,5853,8,4661,12,1192,99.49666178,3.9587695790000055,9419.088243428161,2408.8292611384613
"52.46.137.248","192.168.119.140",29,10786,14,7070,15,3716,100.002730972,2.6031766199999993,21727.300239812394,11419.8935913922
"34.102.232.42","192.168.119.140",34,8350,15,5534,19,2816,102.507689257,4.491317063000011,9857.242180632904,5015.900610889457
"162.219.225.118","192.168.119.140",31,9240,15,6632,16,2608,103.704488154,3.4001596269999936,15603.973289575237,6136.182499881214
"23.198.19.183","192.168.119.140",465,347974,266,330727,199,17247,107.304791956,39.03590110900001,67779.04249250155,3534.592415702904
"13.227.216.166","192.168.119.140",126,55690,64,49516,62,6174,108.954440964,53.056118592999994,7466.207677925831,930.9388117681978
"52.222.139.35","192.168.119.140",11,1086,5,352,6,734,108.956211057,0.5753196689999953,4894.670131641237,10206.499649501899
"92.123.125.28","192.168.119.140",574,428007,311,407673,263,20334,108.957889377,152.70713365,21357.11621354239,1065.2547534081752
"52.94.224.4","192.168.119.140",71,26820,33,15671,38,11149,109.738362906,63.077322959,1987.5288632887716,1414.0105479424742
"52.222.139.54","192.168.119.140",222,145156,114,136201,108,8955,109.992855872,36.33583338599999,29987.14762986062,1971.607455344688
"52.209.199.248","192.168.119.140",114,44131,47,30385,67,13746,110.912756451,44.375942874,5477.742764591968,2478.0994583538322
"104.107.217.226","192.168.119.140",30,9914,14,7638,16,2276,111.182245276,14.471644302000001,4222.326000063126,1258.1846001759197
"104.107.217.239","192.168.119.140",119,75689,66,70720,53,4969,111.192090556,24.16102684900001,23416.223306064327,1645.2943100655211
"13.227.219.95","192.168.119.140",119,93701,74,89709,45,3992,111.298863437,35.024124289000014,20490.790692671177,911.8286509173365
"104.107.217.186","192.168.119.140",24,5880,11,4642,13,1238,111.305859068,1.4361916639999919,25857.273044303234,6896.01551677023
"52.222.139.81","192.168.119.140",59,20071,27,16248,32,3823,112.70079999,33.63471374200002,3864.5787503072347,909.2986559837863
"157.240.201.15","192.168.119.140",213,154598,122,147348,91,7250,113.893046815,32.43065681199998,36347.829981779054,1788.4312468978076
"54.76.60.98","192.168.119.140",28,11097,12,8803,16,2294,113.894756073,11.526545936000005,6109.7227557173,1592.1508578456762
"15.188.95.229","192.168.119.140",42,12574,20,8826,22,3748,113.896467987,32.43975274000002,2176.588723283837,924.2980438327467
"13.227.219.8","192.168.119.140",50,16691,23,13587,27,3104,114.16024994,32.163923697,3379.4384361799216,772.0451097300711
"3.211.206.112","192.168.119.140",36,12207,16,7095,20,5112,114.817191087,31.58558293499999,1797.0223983773378,1294.7679352367795
"52.58.216.84","192.168.119.140",27,10566,11,7609,16,2957,118.437844892,7.2105580509999925,8442.065034280946,3280.7446847639317
"185.89.210.122","192.168.119.140",20,6232,9,4245,11,1987,118.439674152,7.105049511000004,4779.699275483343,2237.282087252156
"142.250.179.194","192.168.119.140",34,9671,15,7203,19,2468,118.527570747,27.807425838,2072.252222687021,710.0261676511965
"91.228.74.208","192.168.119.140",29,7299,13,5209,16,2090,118.528934424,27.807087808999995,1498.61072422379,601.2855468665234
"52.223.40.198","192.168.119.140",59,13939,25,9556,34,4383,118.530254976,43.48650331,1757.9707307122183,806.3191411376781
"3.231.143.108","192.168.119.140",31,7220,14,4897,17,2323,118.807739655,6.6895959019999935,5856.258072073908,2778.0452320660993
"13.227.219.60","192.168.119.140",32,10102,15,7909,17,2193,120.163385526,26.160402686000012,2418.6172040027736,670.6318786670986
"157.240.201.35","192.168.119.140",68,17110,29,12648,39,4462,120.869069913,145.9590699,693.2354396977422,244.56171188577846
"104.99.235.115","192.168.119.140",319,173959,156,155789,163,18170,120.891969185,95.056948549,13111.214056672045,1529.1885782034099
"13.36.218.177","192.168.119.140",18,5566,8,4492,10,1074,121.19641618,3.258405714999995,11028.706411411402,2636.872369959004
"54.171.150.101","192.168.119.140",42,12718,18,10254,24,2464,123.949079988,9.376684581000006,8748.507992496794,2102.2355854800176
"52.222.139.23","192.168.119.140",70,20885,33,16448,37,4437,124.456256667,37.53001272799999,3506.1005961724395,945.803036552597
"104.73.132.208","192.168.119.140",2153,1478147,1152,1388249,1001,89898,126.114457048,91.114454829,121890.56084287928,7893.193251825257
"95.101.125.221","192.168.119.140",635,457545,331,433735,304,23810,126.115729681,23.197153426,149582.14640727703,8211.352337158094
"142.250.179.130","192.168.119.140",322,210337,169,196235,153,14102,126.117201277,118.570247998,13240.083634019895,951.4697144084824
"104.81.140.36","192.168.119.140",91,79656,60,76573,31,3083,126.120757295,12.47393001399999,49109.14197149355,1977.2437373240516
"142.250.179.205","192.168.119.140",36,10044,15,7099,21,2945,127.43298092,18.877510696,3008.447507437185,1248.045909198832
"172.217.168.227","192.168.119.140",112,29198,49,21522,63,7676,130.8173949,123.84674312199999,1390.2343788757644,495.83863452515413
"104.99.232.128","192.168.119.140",32,7420,15,5394,17,2026,133.687481863,12.683214835000001,3402.2919710324372,1277.9094425865253
"52.51.250.251","192.168.119.140",28,11225,12,8803,16,2422,134.692649318,4.632283605999987,15202.86882020414,4182.818162278135
"15.236.176.210","192.168.119.140",61,17589,28,11175,33,6414,134.821111312,133.13965368299998,671.4753833809551,385.3998307834851
"47.88.198.40","192.168.119.140",33,11272,14,9196,19,2076,135.616194449,10.88583963299999,6758.137404209184,1525.6517236992458
"142.250.179.131","192.168.119.140",19,7227,9,5883,10,1344,137.203432525,3.8161284699999953,12332.91813155338,2817.5152080244334
"142.251.36.4","192.168.119.140",20,6673,9,5553,11,1120,137.205272201,4.6148988459999885,9626.213159255909,1941.5376802389012
"47.88.251.178","192.168.119.140",29,10102,12,8597,17,1505,137.207020365,6.005406040999986,11452.348022840402,2004.8602738600448
"142.251.36.14","192.168.119.140",43,16447,19,12093,24,4354,138.556180668,122.08472970400001,792.4332570876,285.31004724711903
"104.18.8.110","192.168.119.140",24,5641,10,3884,14,1757,140.981705309,8.320624700999986,3734.3349948551,1689.2962373739472
"47.91.64.21","192.168.119.140",148,73213,73,65875,75,7338,142.720222614,61.38584391500001,8585.041214546605,956.3116877775027
"52.46.149.60","192.168.119.140",54,17686,26,13445,28,4241,143.938247981,28.888115561000006,3723.3304392208215,1174.462208459316
"34.96.102.137","192.168.119.140",145,88486,83,82231,62,6255,147.053130116,52.160532389999986,12611.987835578919,959.3460363068202
"151.101.2.133","192.168.119.140",150,73577,81,66066,69,7511,147.055061253,120.53643768200001,4384.798573476726,498.50486006998597
"54.155.40.229","192.168.119.140",29,11215,12,7140,17,4075,147.256387368,12.653985403000007,4513.992878991151,2576.263442841588
"3.211.35.115","192.168.119.140",37,11226,16,8692,21,2534,147.295097806,13.235836849000009,5253.615679408557,1531.5994168915422
"54.159.183.74","192.168.119.140",35,12124,15,7029,20,5095,147.41300088,13.111338007,4288.807135471478,3108.759760311166
"151.101.129.69","192.168.119.140",99,67866,63,64453,36,3413,149.456783883,11.276394023999984,45725.96513589163,2421.341427222909
"172.67.74.245","192.168.119.140",26,6782,11,5048,15,1734,149.983906639,12.009182904,3362.760008139185,1155.1160566785552
"13.227.219.71","192.168.119.140",82,57273,48,54084,34,3189,149.991863064,12.008414187,36030.73588754122,2124.510331065915
"52.222.139.108","192.168.119.140",64,33329,31,30250,33,3079,150.032523542,11.96818809299998,20220.270446914372,2058.122734084276
"34.110.181.170","192.168.119.140",126,51294,61,44313,65,6981,150.044048171,49.17075639000001,7209.6511428100885,1135.7970489011627
"142.250.179.168","192.168.119.140",151,112549,86,106725,65,5824,150.045816439,11.959027630000008,71393.76431058545,3895.9689233530075
"52.222.139.71","192.168.119.140",40,15464,19,13140,21,2324,150.047637469,11.946063753999994,8799.551229985847,1556.3285432638593
"13.227.219.99","192.168.119.140",34,9466,16,7281,18,2185,150.049840799,11.950538016999985,4874.090180470581,1462.6956522906496
"52.222.139.110","192.168.119.140",36,11642,17,9478,19,2164,150.051847978,11.948335207999975,6345.988682107969,1448.9047803420178
"13.227.211.72","192.168.119.140",26,9861,12,7953,14,1908,150.259558072,11.222287246999997,5669.432496214915,1360.150534738848
"142.250.179.166","192.168.119.140",36,9502,16,6927,20,2575,150.261056073,11.743523042000021,4718.8564966243885,1754.1584349368848
"23.202.229.154","192.168.119.140",79,51539,46,48416,33,3123,150.303782066,11.696102364000012,33115.98923690812,2136.0962158555863
"157.240.247.35","192.168.119.140",127,32515,53,18540,74,13975,150.305244338,115.11466177399998,1288.4544654371718,971.2055638880516
"192.168.119.140","199.232.148.157",57,24558,29,2846,28,21712,150.309462972,11.696238303000001,1946.6087651582964,14850.5866159933
"151.139.128.11","192.168.119.140",65,29911,31,26785,34,3126,152.836279079,19.91171585699999,10761.503505719704,1255.9439969714315
"52.222.139.56","192.168.119.140",72,43851,39,40733,33,3118,152.837446656,9.154943809000002,35594.32005247821,2724.648072168194
"104.18.41.98","192.168.119.140",55,11967,24,8346,31,3621,155.964087325,43.251869863999985,1543.7020459449152,669.751390889832
"47.246.48.252","192.168.119.140",544,341016,284,321114,260,19902,160.462723067,38.75276609199997,66289.77126178148,4108.506722385119
"2.16.42.31","192.168.119.140",24,7381,11,6092,13,1289,160.4649827,10.707764850999979,4551.463417264774,963.0394525368177
"47.246.48.251","192.168.119.140",1904,1233204,959,1168456,945,64748,160.501070777,105.470784622,88627.84166725719,4911.160961364029
"151.101.65.69","192.168.119.140",94,67024,58,63587,36,3437,161.011139884,11.735369135000013,43347.25172664962,2343.0025663185047
"52.222.139.46","192.168.119.140",28,8180,13,6648,15,1532,161.012337201,11.725796012999979,4535.640901567515,1045.2168864623095
"142.251.36.6","192.168.119.140",108,30163,48,22247,60,7916,161.26089031,70.63603460599998,2519.620488221494,896.5395686951654
"151.101.2.202","192.168.119.140",7,478,3,206,4,272,161.264699351,0.11795266699999729,13971.706125136092,18448.077990470956
"104.16.46.182","192.168.119.140",116,36106,52,16445,64,19661,162.4365525,85.788627798,1533.5365930991973,1833.436482634437
"3.233.129.60","192.168.119.140",29,8627,12,6526,17,2101,163.215741374,9.616658338999997,5428.912846812122,1747.8004736672183
"35.190.59.101","192.168.119.140",40,10090,18,7022,22,3068,163.708875707,9.041699335999994,6212.9913761158095,2714.533970652706
"172.217.168.194","192.168.119.140",48,12864,22,9630,26,3234,168.352850448,9.890418642000014,7789.356829937097,2615.865003947723
"151.101.193.69","192.168.119.140",643,402453,351,377547,292,24906,168.356518236,63.759001522999995,47371.75814948184,3125.0175699210818
"151.101.1.69","192.168.119.140",249,137481,138,126363,111,11118,168.358120874,67.92617357499998,14882.392850876855,1309.4216164229156
"142.251.36.2","192.168.119.140",21,9174,9,7958,12,1216,168.637678513,2.7057190040000023,23529.4204260983,3595.3474790318587
"104.16.49.182","192.168.119.140",83,44154,44,40525,39,3629,169.538418002,98.191430156,3301.7138001242333,295.66735054042795
"151.101.1.44","192.168.119.140",85,62380,52,59290,33,3090,169.676972234,8.572445893000008,55330.76626209037,2883.6577458232287
"35.201.67.47","192.168.119.140",94,25027,42,18750,52,6277,169.678031058,8.566357899000025,17510.358750888743,5862.001166897528
"192.168.119.140","216.58.208.97",24,7153,14,1481,10,5672,171.76002948000001,6.4837904549999905,1827.3261732052717,6998.3754587578
"151.101.130.133","192.168.119.140",43,11126,21,6548,22,4578,171.969349594,27.223832747000017,1924.1963645171363,1345.2918382344915
"152.199.22.24","192.168.119.140",31,7334,14,5269,17,2065,171.971947202,6.192728339000013,6806.69289730326,2667.6448724485163
"47.88.198.68","192.168.119.140",228,71634,96,57642,132,13992,174.138666327,25.233284624999982,18274.909780993297,4436.045551085289
"47.74.138.66","192.168.119.140",58,22378,26,19692,32,2686,174.140424802,19.200439535999976,8204.812171337378,1119.1410467302558
"47.88.128.4","192.168.119.140",171,62499,76,53098,95,9401,174.143968367,87.19882930299997,4871.441547958785,862.4886434961869
"192.168.119.140","207.241.224.2",792,475670,397,38587,395,437083,176.097904498,87.189898675,3540.5018779831726,40104.00348134136
"142.250.179.132","192.168.119.140",37,11901,17,9737,20,2164,176.099333539,91.79106546699998,848.6228981403922,188.60223390939805
"52.222.139.116","192.168.119.140",1079,761835,564,721771,515,40064,179.120017852,69.10552636,83555.80666472187,4638.00823005554
"52.222.139.89","192.168.119.140",31,8330,14,6660,17,1670,179.13684696,87.97794003799999,605.6063596963849,151.8562493532977
"52.222.139.41","192.168.119.140",56,16217,26,13172,30,3045,179.137783802,16.29619151,6466.296124179507,1494.827793662815
"54.175.105.190","192.168.119.140",33,11992,13,6897,20,5095,181.213351177,18.07463323800002,3052.676050100881,2255.094167792372
"192.168.119.140","209.54.180.46",29,10787,15,3717,14,7070,183.694699272,11.821427494999995,2515.432253217911,4784.53215772145
"47.88.251.189","192.168.119.140",25,9732,11,8521,14,1211,185.089365314,8.251168444000001,8261.617789365298,1174.136737814972
"104.73.152.39","192.168.119.140",2346,1863655,1286,1776521,1060,87134,190.27647642,71.37982060500002,199106.24430743477,9765.673184546662
"104.26.2.116","192.168.119.140",44,17825,21,15661,23,2164,193.512527982,10.59311171600001,11827.308477334658,1634.2695578157334
"52.222.139.24","192.168.119.140",32,9305,15,7267,17,2038,193.519958085,10.579551225999978,5495.129118249058,1541.0861625143223
"3.94.178.28","192.168.119.140",63,35667,30,32460,33,3207,193.521599526,10.652329082000023,24377.767340928218,2408.4873648292296
"192.168.119.140","207.241.239.241",71,20603,41,5263,30,15340,194.86796735,49.956803071000024,842.8081344629,2456.5222843740994
"192.168.119.140","207.241.225.102",66,18174,35,4003,31,14171,194.869665876,66.92496825400002,478.50601704373565,1693.9567243384406
"192.168.119.140","209.54.180.49",34,13452,18,5658,16,7794,200.814200264,15.942288090000005,2839.2411267735397,3911.107342183275
"52.222.139.10","192.168.119.140",165,98514,85,91278,80,7236,201.56742364,61.57134472499999,11859.80269330556,940.177614417045
"52.222.139.73","192.168.119.140",98,71577,59,67839,39,3738,204.058650133,15.049252028000012,36062.390276290986,1987.0755001219902
"52.222.139.26","192.168.119.140",34,9597,16,7457,18,2140,204.060245895,11.115636022999979,5366.854391108386,1540.1727768502008
"66.254.114.41","192.168.119.140",151,81913,77,74114,74,7799,204.065501316,61.320360494,9669.088622823972,1017.4760796800086
"64.210.135.113","192.168.119.140",18,4613,7,3448,11,1165,204.127341031,10.995335791000002,2508.7001001441263,847.6321394048454
"59.82.33.227","192.168.119.140",32,10345,12,4676,20,5669,204.852688356,14.05416706600002,2661.7016735554403,3226.943282161204
"13.227.217.72","192.168.119.140",65,34113,32,31030,33,3083,205.327436069,11.829372830000011,20985.051664822688,2084.9795128149644
"67.220.240.30","192.168.119.140",23,7418,11,6292,12,1126,206.24294026,9.793808587000001,5139.573594159728,919.7647595397098
"13.227.219.122","192.168.119.140",66,26035,32,21057,34,4978,207.036459836,24.86804304399999,6773.995030567717,1601.4127018172624
"52.7.35.104","192.168.119.140",34,12059,14,6963,20,5096,215.82258818,16.144208030000016,3450.4015245893697,2525.2400070813483
"192.168.119.140","205.185.208.142",584,307657,292,25106,292,282551,217.076627839,46.04680330200003,4361.822875797248,49089.357738364866
"66.254.114.181","192.168.119.140",22,6390,9,5158,13,1232,217.078157662,13.226947287999991,3119.691876101777,745.1454810696761
"64.210.135.116","192.168.119.140",18,4613,7,3448,11,1165,217.154308535,13.162306749999999,2095.6812908193315,708.0825707089679
"64.210.135.119","192.168.119.140",18,4612,7,3447,11,1165,217.156370244,12.730390638000017,2166.155052436967,732.1063638204429
"13.227.219.120","192.168.119.140",102,80336,64,76817,38,3519,218.258205313,13.627929907999999,45093.862688510686,2065.7576161639886
"151.101.2.114","192.168.119.140",342,223611,188,210346,154,13265,218.259502683,36.399364976000015,46230.696637414854,2915.4354772389684
"52.46.149.63","192.168.119.140",34,12802,16,7794,18,5008,219.796777658,24.234084123000002,2572.905156371194,1653.2087532854684
"23.35.149.98","192.168.119.140",117,67427,62,61765,55,5662,219.79904411,24.88324636599998,19857.53758702308,1820.341258280979
"52.50.227.251","192.168.119.140",30,7825,13,5438,17,2387,220.465528515,15.82013747100001,2749.912892966161,1207.0691569529654
"13.227.219.82","192.168.119.140",32,9276,15,7135,17,2141,220.468504773,15.752176950000006,3623.62612997437,1087.3417721478804
"192.168.119.140","216.58.214.2",38,11660,21,2547,17,9113,223.343712303,12.940396256000014,1574.6040226977095,5633.830568843434
"142.251.39.98","192.168.119.140",52,17586,23,13905,29,3681,229.79661496,37.17534220499999,2992.30601258698,792.1379670861326
"167.40.79.16","192.168.119.140",186,139190,109,130522,77,8668,231.271752709,36.61228341399999,28519.827299291657,1894.009155776498
"52.22.241.9","192.168.119.140",30,7141,13,4660,17,2481,232.847850451,15.454113492000005,2412.3027192273703,1284.3182503010955
"104.16.48.182","192.168.119.140",22,5467,9,4295,13,1172,232.850612277,34.269020334999965,1002.6548662351785,273.59988433704984
"52.222.139.77","192.168.119.140",32,9381,15,7082,17,2299,233.611877598,14.612662427000004,3877.185303022944,1258.6344269485667
"35.190.91.160","192.168.119.140",48,9967,22,7118,26,2849,234.647105144,13.843715583999995,4113.346569024689,1646.3788107827113
"47.88.198.69","192.168.119.140",38,12789,17,10655,21,2134,236.600516373,18.228679191999987,4676.147904199732,936.5461874765112
"8.238.16.250","192.168.119.140",26,7039,11,5484,15,1555,237.514735244,9.503980439999992,4616.171116614802,1308.925252796502
"192.168.119.140","216.239.34.178",84,34594,46,5240,38,29354,241.202049374,20.453883738000002,2049.4885243783524,11481.046974160716
"151.101.1.21","192.168.119.140",102,51570,53,46911,49,4659,245.056003732,16.980234292999995,22101.46182462926,2195.0227162274887
"192.168.119.140","216.239.32.36",35,9390,21,2743,14,6647,245.068464706,13.08775982200001,1676.6811355380314,4063.032995961099
"52.222.139.28","192.168.119.140",26,9390,12,7306,14,2084,246.262069952,12.543843921000018,4659.496751402533,1329.0981699867068
"52.4.99.248","192.168.119.140",35,12125,15,7029,20,5096,247.816493983,15.417040276000023,3647.392689732889,2644.346727397752
"18.65.39.115","192.168.119.140",32,9367,15,7282,17,2085,247.818176777,13.852555110999987,4205.433548771106,1204.109990275715
"142.251.36.42","192.168.119.140",46,12431,21,9611,25,2820,249.260852674,13.877481931999995,5540.486406449895,1625.6551520329522
"52.19.27.104","192.168.119.140",27,11083,11,7411,16,3672,249.262838025,17.22298649800001,3442.3762688825605,1705.6275346561547
"172.217.168.202","192.168.119.140",119,93094,71,88787,48,4307,249.264635404,16.120983067999987,44060.34030331137,2137.338638385823
"142.250.102.156","192.168.119.140",45,10631,19,7305,26,3326,250.046319129,14.462742585999962,4040.727382963335,1839.7617078351884
"8.238.16.122","192.168.119.140",111,82210,66,77825,45,4385,250.924461919,13.597258634000013,45788.64142829391,2579.9318042154678
"8.238.17.122","192.168.119.140",195,129359,93,121022,102,8337,250.927800787,16.199603954000025,59765.41171927458,4117.137689871199
"142.250.27.156","192.168.119.140",6,412,2,140,4,272,255.140430854,3.797087084999987,294.96294789351765,573.0708701931201
"13.227.219.23","192.168.119.140",31,9826,15,7784,16,2042,259.385487316,7.8551351769999656,7927.552944261734,2079.6586731991856
"13.227.219.69","192.168.119.140",28,8117,13,6597,15,1520,259.386860571,8.587366504999977,6145.772393582046,1416.0336574571336
"192.168.119.140","192.229.221.25",38,15932,20,2762,18,13170,263.058180609,4.500067738000041,4910.148310305234,23412.98090033307
"52.222.139.5","192.168.119.140",19,7382,9,6326,10,1056,263.065510334,4.82395448699998,10490.977917885195,1751.2603037127358
"52.51.135.205","192.168.119.140",13,5647,6,4847,7,800,264.457003938,2.7050168339999914,14334.846095083534,2365.974185283026
"167.44.7.21","192.168.119.140",30,14296,14,12566,16,1730,264.458019166,3.41803164800001,29411.079344107846,4049.114058993043
"104.16.45.182","192.168.119.140",3,194,1,66,2,128,265.337704058,0.048352912000041215,10919.714618212653,21177.62835047302
"34.242.116.160","192.168.119.140",1,74,0,0,1,74,267.958625214,0,0,0

